111111111111
130000300001
132033003001
130030P03001
132030300311
111111111111
