111111111111
110001001001
111010000001
110010001001
111010P00111
111111111111
