111111111111
1000C0C00101
11P00C000001
101C10111001
100E1C111101
110000100001
111111111111
