1111111
1C000C1
11P00C1
1010101
111E1C1
1111111
