111111111111
1000C0C00101
11P00C000001
101C10111001
111E1C111101
1111111000C1
111111111111
