111111111111
100000P00001
101010101001
10000C0000C1
1C00000E0111
111111111111
